distorted: berubah ke hal yang tidak normal
collision: tabrakan
swelling: pembengkakkan
surged: melonjak
fractures: patah tulang
shattered: hancur
upright: jujur, dengan tegak lurus
seizure: kejang
stretcher: usungan
rattled: bingung
bumpy: benjolan
severe: berat
undergo: menjalani
induced: dipaksa
priest: pendeta
restlessly: gelisah
vividly: dengan jelas
varsity: universitas
innings: babak
boastful: sombong
fared: bernasib
endured: bertahan	
underwhelming: mengecewakan
trajectory: lintasan
relentless: tanpa henti
degraded: direndahkan/diturunkan
astounding: mencengangkan
noteable: penting
enormous: sangat penting
apperent: mencolok
strikingly: sekali	
pace: laju
magnified: diperbesar
span: menjangkau, masa
conversely: sebaliknya
clutter: kekacauan
magnifies: memperbesar
strain: tekanan
persist: bertahan
aggravations: kejengkelan
unleash: memperlancar
thershold: ambang
valley: lembah
hallmark: tanda
tangible: nyata
wayside: pinggir jalan
plateau: dataran
fashion: mode, cara, 
propelled: didorong
presumably: sepertinya, kayanya
tidy up: merapikan
sloppy: ceroboh
pile: tumpukan
clutter: kekacauan
narrow: sempit
antidote: penangkal
outweighs: melebihi