hassle: kerepotan (n)
occur: terjadi
incongruent: tidak selaras
morphed: berubah
incorporates: menggabungkan
pursuing: mengejar
allegiance: kesetiaan
slumber: tidur
upholds: menjunjung tinggi
emerges: muncul
embody: mewujudkan
virtue: kebajikan
scribbled: coretan
gradual: bertahap
casting: penuangan
reinforce: memperkuat
lay: memberikan
lever: tuas
dart out: melesaat keluar
gradually: bertahap
occasionally: kadang-kadang
stumble: tersandung
vibrancy: semangat
cue: isyarat
cravings: keinginan
friction: gesekan
sufficient: memadai
urge: keinginan
alter: mengubah
doomed: dikutuk
upon: saat
obstructed: terhambat
discern: melihat
curators: kurator, kepala museum
counterfeit: palsu
digest: mencerna
firmly: dengan kuat
peculiar: aneh
binge: berlebihan